OOOOOOOOOOOOOOOOOOOOOOOOOOOO
O  OOOOO  OOOO OOOOOOOOOOOOO
O  OOOOO OO OOO         E OO
OOOOOOOOOR      P         OO
OOOOOOOOOOOOOOOOOOOOOOOOOOOO
