OOOOOOOOOOOOOOOOOOO
O EOOOOOOOOOOOOOOOO
O O         OOOOOOO
O   O OOOOOOOOOOOOO
OOOOO  OOOO OOOOOOO
OOOO O OO   OOOOOOO
O    O O  O  OOOOOO
O OOOO   OO OOOOOOO
O OOO OOOOO OOOOOOO
O OOO             O
O OOO OOOOO OOOOO O
O                 O
O                 O
O  R OOOOOO       O
OOOOOOOOOOOOOOOOOOO
