OOOOOOOOOOOOOOOOOOOOOOOOOOOOOOOOOOOOOOOOOOOOOOOOO
O        O           OE                        OO
OOOOOOO OO O OOOOOOOOOOO OOOOOOOOOOOOOOOOOOOOOO O
OOOOOOO  O O             OOOOOOOOOOOOOOOO OOOOO O
OOOOOOOOOO  OOOOOOOOOOOOOOOOOOOOOOOOOOOOO OOOOO O
OOOOOOO OOO OOOOOOOOOOOO OOOOOOOOOOOOOOOO OOOOO O
OOOOOOO OOO OOOOOOOOOOOO                  OOOOO O
OOOOOOO OOO OOOOOOOOOOOOOOOOOOOOOOOOOOOOO       O
OOOOOO  OOO OOOOOOOOOOOOOOOOOOOOOOOOOOOOOOOOOO OO
OOOOOOO OOO OOOOOOOOOOOOOOOOOOOOOOOOOOOOOOOOOO OO
OOO                                             O
OOOOOOOOOOOOOOOOOOOOOOOOOOOOOOOOOOOOOOOOOOOOOO  O
OOOOOOOOOOOOOOOOOOOOOOOOOOOOOOOOOOOOOOOOOOOOOO  O
O          R                                    O
OOOOOOOOOOOOOOOOOOOOOOOOOOOOOOOOOOOOOOOOOOOOOOOOO
